1111111111111111111111
1111111100100000111111
1110000000000000111111
1000000000000000111111
1000000000000000111111
1100000000000000011111
1100000000000000011111
1100000000000000011111
1100000000000000011111
1100011100000000011111
1111111000000000011111
1100000000000000001111
1100000000000000001111
1100000000000000001111
1110000000000000001111
1110000000000000001111
1110000000000000000111
1110000000000000000111
1110000000000000111111
1110000111111111111101
1111111111110111111111
1111111111111111111111
1111101111111111111111
1111011111111111111111
1111011111111111111111
1111111111111111111111
